+-+-+-+-+-+
|   | | | |
+-+ + + + +
|       | |
+ +-+ + + +
|   | |   |
+-+-+-+-+-+
