+-+-+-+-+-+
|         |
+ +-+-+ + +
|   | | | |
+-+ + + +-+
|     |   |
+ +-+-+-+-+
| | | | | |
+ + + + + +
|         |
+-+-+-+-+-+
