+-+-+-+-+-+-+
|       | | |
+ +-+-+-+ + +
|     | | | |
+ + +-+ + + +
| |     |   |
+ +-+ +-+-+ +
| | |       |
+ + +-+-+ +-+
| | | |   | |
+ + + + +-+ +
| |   |     |
+ +-+ +-+-+ +
|         | |
+-+-+-+-+-+-+
