+-+-+-+-+
|   | | |
+-+ + + +
|     | |
+ + +-+ +
| |   | |
+-+ +-+ +
|       |
+-+-+-+ +
|       |
+-+-+-+-+
