+-+-+-+-+-+
|       | |
+-+ + +-+ +
|   | | | |
+ +-+-+ + +
|         |
+-+-+ + + +
|   | | | |
+-+ +-+-+ +
|     | | |
+ + + + + +
| | |   | |
+-+-+-+ + +
|         |
+-+-+-+-+-+
