+-+-+-+-+-+
|       | |
+-+-+ + + +
|   | | | |
+-+ +-+ + +
| |   | | |
+ +-+ + + +
| | |   | |
+ + +-+ + +
|         |
+-+-+-+-+-+
