+-+-+-+-+-+-+-+-+-+-+-+-+-+-+-+-+
| |   | | |   | | |   |     | | |
+ + +-+ + + + + + + + +-+-+ + + +
| | | |     |     | |   | |   | |
+ + + + +-+-+-+ +-+ +-+-+ + + + +
| | | | | |   | |       | | | | |
+ + + + + + +-+ +-+ + +-+ + + + +
| |     | |         |       |   |
+ + +-+-+ + +-+ +-+-+ +-+ + +-+ +
|   | | | |   |     |   | |   | |
+-+ + + + +-+-+ + + + + +-+ +-+-+
| |   |     |   | | | | |   | | |
+ + +-+ +-+-+-+ + +-+ + + +-+ + +
| | |   |   | | |   | | |       |
+ + +-+ + +-+ +-+-+-+ + +-+-+ +-+
| | |   |   |       | |     |   |
+ + + +-+ +-+ +-+-+-+-+ +-+-+-+ +
| | | |   | | | |       | |     |
+ + + + + + + + +-+ +-+-+ +-+-+ +
|   | | | | | | |   | |     |   |
+-+ + +-+ + + + +-+ + + + + + + +
| | | |   | |   | | |   | | | | |
+ + + +-+ + + +-+ + +-+ +-+-+-+ +
| | | | | | |   |   |   | |     |
+ + + + + + +-+ + +-+ + + + +-+ +
|       | |   |       |   |   | |
+ + +-+ + + +-+-+ + + +-+ +-+-+-+
| |   |   | |   | | |   |   |   |
+ + +-+-+-+ +-+ +-+-+-+ + + +-+ +
| | | |   |   | | |   | | | | | |
+ +-+ + +-+ +-+ + + +-+ +-+ + + +
|                     |   |     |
+-+-+-+-+-+-+-+-+-+-+-+-+-+-+-+-+
