+-+-+-+-+-+-+
|   | | |   |
+-+ + + + +-+
| |     |   |
+ +-+ +-+-+ +
| |       | |
+ + +-+-+-+ +
|           |
+-+-+-+-+-+-+
